border_size=1
usage=map

Gg          , Gg          , Gg          , Gg          , Gg          , Gg          , Gg          , Gg          , Gg          , Gg          , Gg          , Gg          , Gg          , Gg          , Gg          , Gg          , Gg          , Gg          , Gg          , Gg          , Gg          , Gg          , Gg          , Gg          , Gg          , Gg          , Gg          , Gg          , Gg          , Gg          , Gg          , Gg          , Gg          , Gg          , Gg          , Gg          , Gs^Fp       , Gg          , Gg          , Gg          , Wo          , Gg          , Wo          , Gg          , Wo          , Gg          
Gg          , Ggf         , Gg          , Gg          , Gg          , Gg          , Gg          , Gg          , Gg          , Gg          , Ggf         , Gg          , Gg          , Gg          , Gg          , Gg          , Gg          , Gg          , Gg          , Gg          , Ce          , 2 Ke        , Ce          , Gg          , Gg          , Gg          , Gg          , Gg          , Gg          , Gg          , Gg          , Gg          , Gg          , Gg          , Gg          , Gg          , Gs^Fp       , Gg          , Ss          , Wo          , Ss          , Wo          , Ss          , Wo          , Ss          , Wo          
Gg          , Ggf         , Gg          , Gg^Vh       , Gg          , Ggf         , Gg^Wm       , Gg          , Gg          , Gg          , Gg          , Gg          , Gg          , Gg          , Gg          , Gg          , Gg          , Gg          , Gg          , Gg          , Ce          , Gg          , Ce          , Ce          , Ce          , Gg          , Gg          , Gg          , Gg          , Gg          , Gg          , Gg          , Gg^Vh       , Gg          , Gg          , Gg          , Gs^Fp       , Ss          , Gg          , Ss          , Ss          , Wo          , Ss          , Wo          , Wo          , Wo          
Gg          , Gg          , Ggf         , Gg          , Gg          , Ggf         , Gg          , Gg          , Gg          , Gg^Vh       , Gg          , Gg          , Ggf         , Gg          , Ds          , Gg          , Gg          , Ce          , Ce          , Gg^Vh       , Ce          , Gg          , Gg          , Gg          , Ce          , Gg          , Gg          , Gg          , Gg          , Gg          , Gg          , Gg          , Gg          , Gg          , Gg          , Gg          , Gg          , Gg          , Gs^Fp       , Gs^Fp       , Ss          , Ww          , Ss          , Ss          , Wo          , Ss          
Gg          , Gg          , Gg          , Gg          , Gg          , Gg          , Gg^Vh       , Gg          , Ggf         , Dd^Do       , Gg          , Ggf         , Gg          , Ggf         , Gg          , Gg          , Gg          , Gg          , Gg          , Ce          , Gg          , Ce          , Gg^Vh       , Ce          , Gg^Vh       , Ce          , Gg          , Gg          , Gg          , Gg          , Gg          , Gg          , Gg          , Gg          , Gg          , Gg          , Gg^Vh       , Gg          , Gg          , Ss          , Gg          , Ww          , Ww          , Ss          , Gg          , Ss          
Gg          , Gg          , Gg          , Gg          , Gg          , Gg          , Gg          , Gg          , Gg          , Ww          , Gg          , Gg          , Ggf         , Gg          , Gg          , Gg          , Gg          , Gg          , Ggf         , Gg          , Gg          , Ce          , Gg          , Ce          , Ce          , Gg          , Ds          , Gg          , Gg          , Gg          , Gg^Vh       , Gg          , Gg          , Gg          , Gg          , Gg          , Gg          , Gg          , Gg          , Gg          , Gs^Fp       , Ss          , Ww          , Ss          , Ss          , Gg          
Gg          , Gg          , Ggf         , Gg          , Gg          , Gg^Vh       , Gg          , Gg          , Ggf         , Ww          , Gg          , Gg          , Gg          , Gg          , Ggf         , Gg          , Gg          , Gg          , Ggf         , Gg          , Gg          , Gg          , Gg          , Gg          , Gg          , Gg          , Gg          , Gg          , Gg          , Gg          , Gg          , Gg          , Gg          , Gg          , Gg^Vh       , Gg          , Gg          , Gg          , Gg          , Gg          , Gg          , Ww          , Gg          , Gs^Fp       , Gs^Fp       , Gg          
Gg          , Gg          , Gg          , Gg          , Ggf         , Gg          , Gg          , Gg          , Gg          , Ww          , Ww          , Gg          , Gg^Vh       , Gg          , Gg          , Gg          , Gg          , Gg          , Ggf         , Gg          , Gg          , Gg          , Gg          , Gg          , Gg          , Gg          , Gg          , Gg          , Gg          , Gg          , Gs^Fp       , Gs^Fp       , Gg          , Gg          , Gg          , Gg          , Gg          , Gg          , Gg          , Gg          , Gg          , Ww          , Ww          , Gg^Vh       , Gg          , Gg          
Gg          , Gg^Vh       , Gg          , Ggf         , Gg          , Gg          , Gg          , Gg          , Gg^Vh       , Gg          , Ww          , Gg          , Gg          , Gg          , Gs^Fp       , Gg          , Ggf         , Gg          , Gs^Fp       , Gg          , Ds          , Gg^Wm       , Gg          , Gg          , Gg          , Gg          , Gg          , Gg          , Gg          , Gg          , Ds          , Gg          , Gg          , Gg          , Gg          , Gg          , Gg          , Gg          , Gg          , Gg^Vh       , Gg          , Gg          , Ww          , Gg          , Gg          , Gg          
Gg          , Gg          , Gg          , Gg          , Gg          , Gg          , Gg          , Gg          , Gg          , Gg          , Gg          , Ww          , Ggf         , Gg          , Ds          , Gg          , Ww          , Ww          , Ww          , Gs^Fp       , Gg          , Gg          , Gg          , Gg          , Gg          , Ds          , Gg          , Gg          , Gg          , Gg          , Gs^Fp       , Gg          , Gg          , Gg          , Gg          , Gg          , Gg          , Gg          , Gg          , Gg          , Ww          , Ww          , Gg          , Gg          , Gg          , Gg          
Gg          , Gg          , Gg          , Gg          , Ggf         , Ggf         , Gg          , Ggf         , Ggf         , Ggf         , Gg          , Ww          , Ww          , Gg          , Gs^Fp       , Gg          , Ww          , Gg          , Gg          , Ww          , Gg          , Gg          , Gg          , Gg          , Gg          , Gg          , Gg          , Gg          , Gg          , Gg          , Gg          , Gs^Fp       , Gg          , Gg          , Gg          , Gg          , Gg          , Gg          , Ww          , Ww          , Gg          , Gg          , Gg          , Gg          , Gg          , Gg          
Gg          , Gg          , Gg          , Gg          , Gg          , Gg          , Gg          , Gg          , Gg          , Gg          , Ggf         , Gg          , Gg          , Ww          , Ww          , Gg          , Ww          , Ww          , Ww          , Ww          , Gg          , Gg          , Gg          , Gg          , Gg          , Gg          , Gg          , Gg          , Gg          , Gg          , Gg          , Gg          , Gs^Fp       , Gg          , Gg          , Gg          , Gg          , Gg          , Ww          , Gg          , Gg          , Gg          , Gg          , Gg          , Gg          , Gg          
Gg          , Ggf         , Gg          , Gg          , Gg          , Gg          , Gg          , Gg          , Gg          , Gg          , Gg          , Gg          , Gg          , Ggf         , Gg          , Ww          , Gg          , Gg          , Ww          , Gg          , Gg          , Gg          , Gg          , Gg          , Gg          , Gg          , Gg          , Gg          , Gg          , Gg          , Gg          , Gg          , Gg          , Gg          , Gg          , Gg          , Gg          , Ww          , Gg          , Gg          , Gg          , Gg          , Gg          , Gg          , Gg          , Gg          
Gg          , Gg          , Gg          , Gg          , Ww          , Ww          , Ww          , Gg          , Ww          , Gg          , Ww          , Gg          , Gg          , Gg          , Ww          , Gg          , Gg          , Gg          , Gg          , Ww          , Ww          , Gg          , Gg          , Gg          , Gg          , Gg          , Gg          , Gg          , Gg          , Gg          , Gg          , Gg          , Gg          , Gg          , Gg          , Gg          , Gg          , Ww          , Gg          , Gg          , Gg          , Gg          , Gg          , Gg          , Gg          , Gg          
Ww          , Gg          , Ww          , Gg          , Ww          , Gg          , Ww          , Ww          , Ww          , Ww          , Ww          , Gg          , Ww          , Ww          , Ww          , Gg          , Ww          , Gg          , Ww          , Gg          , Ww          , Ww          , Ww          , Ww          , Gg          , Gg          , Ww          , Gg          , Ww          , Gg          , Gg          , Gg          , Ww          , Gg          , Gg          , Gg          , Gg          , Ww          , Gg          , Gg          , Gg          , Gg          , Gg          , Gg          , Ww          , Gg          
Ww          , Ww          , Ww          , Ww          , Ww          , Ww          , Ww          , Ww          , Ww          , Ww          , Gg^Wm       , Ww          , Ww          , Ww          , Ww          , Gg          , Ww          , Ww          , Ww          , Ww          , Gg          , Ww          , Ww          , Ww          , Ww          , Ww          , Gg          , Ww          , Gg          , Ww          , Gg          , Ww          , Gg          , Ww          , Ww          , Ww          , Ww          , Ww          , Ww          , Gg          , Ww          , Ww          , Gg          , Ww          , Gg          , Gg          
Wo          , Wo          , Wo          , Wo          , Wo          , Wo          , Wo          , Wo          , Wo          , Ww          , Ww          , Ww          , Ww          , Ww          , Ww          , Ww          , Ww          , Ww          , Ww          , Ww          , Gg          , Ww          , Gg          , Gg          , Ww          , Ww          , Ww          , Ww          , Ww          , Gg          , Ww          , Ww          , Ww          , Ww          , Ww          , Gg          , Ww          , Gg          , Ww          , Gg          , Ww          , Gg          , Ww          , Ww          , Ww          , Gg          
Wo          , Wo          , Wo          , Wo          , Wo          , Wo          , Wo          , Wo          , Wo          , Wo          , Wo          , Wo          , Wo          , Wo          , Wo          , Wo          , Wo          , Wo          , Ww          , Ww          , Ww          , Ww          , Ww          , Ww          , Gg          , Gg          , Ww          , Ww          , Gg          , Ww          , Gg          , Ww          , Ww          , Gg          , Gg          , Ww          , Wo          , Ww          , Wo          , Ww          , Wo          , Ww          , Ww          , Gg          , Gg          , Ww          
Wo          , Wo          , Wo          , Wo          , Wo          , Wo          , Wo          , Wo          , Wo          , Wo          , Wo          , Wo          , Wo          , Wo          , Wo          , Wo          , Wo          , Wo          , Wo          , Wo          , Wo          , Ww          , Gg          , Ww          , Ww          , Ww          , Ww          , Gg          , Gg          , Ww          , Ww          , Gg          , Gg          , Ww          , Ww          , Ww          , Wo          , Wo          , Wo          , Wo          , Wo          , Ww          , Wo          , Ww          , Ww          , Ww          
Wo          , Wo          , Wo          , Wo          , Wo          , Wo          , Ww^Vm       , Wo          , Wo          , Wo          , Wo          , Wo          , Wo          , Wo          , Wo          , Wo          , Wo          , Wo          , Wo          , Wo          , Wo          , Ww          , Ww          , Gg          , Ww          , Gg          , Ww          , Ww          , Ww          , Ww          , Gg^Wm       , Ww          , Ww          , Ww          , Gg^Vh       , Ww          , Wo          , Wo          , Wo          , Wo          , Wo          , Wo          , Wo          , Wo          , Ww          , Gg          
Wo          , Wo          , Wo          , Wo          , Wo          , Wo          , Wo          , Wo          , Wo          , Wo          , Wo          , Wo          , Wo          , Wo          , Wo          , Wo          , Wo          , Wo          , Wo          , Wo          , Wo          , Wo          , Ww          , Ww          , Gg          , Ww          , Gg          , Gg          , Ww          , Ww          , Ww          , Ww          , Ww          , Gg          , Ww          , Ww          , Wo          , Wo          , Wo          , Wo          , Wo          , Wo          , Wo          , Wo          , Wo          , Ww          
Wo          , Wo          , Wo          , Wo          , Wo          , Wo          , Wo          , Wo          , Wo          , Wo          , Wo          , Wo          , Wo          , Wo          , Wo          , Wo          , Wo          , Wo          , Wo          , Wo          , Wo          , Wo          , Ww          , Gg^Vh       , Ww          , Ww          , Ww          , Gg          , Ww          , Gg          , Ww          , Gg          , Gg          , Ww          , Wo          , Wo          , Wo          , Wo          , Wo          , Wo          , Ww^Vm       , Wo          , Wo          , Wo          , Wo          , Wo          
Wo          , Wo          , Wwr         , Wo          , Wo          , Wo          , Wo          , Wo          , Wwr         , Wo          , Wwr         , Wwr         , Wo          , Wo          , Wo          , Wo          , Ww          , Wo          , Wo          , Wo          , Wo          , Ww          , Gg          , Ww          , Gg          , Ww          , Gg          , Ww          , Ww          , Gg          , Ww          , Ww          , Ww          , Gg          , Ww          , Wo          , Ww          , Wo          , Wo          , Wo          , Wo          , Wo          , Wo          , Ww          , Ww          , Wo          
Wwr         , Wwr         , Gg          , Wwr         , Wwr         , Gg          , Wwr         , Wwr         , Gg          , Wwr         , Gg          , Wwr         , Wwr         , Wwr         , Gg          , Ww          , Gg          , Ww          , Ww          , Wo          , Ww          , Ww          , Ww          , Gg          , Ww          , Ww          , Gg          , Ww          , Ww          , Ww          , Gg          , Ww          , Gg          , Ww          , Gg          , Ww          , Gg          , Ww          , Ww          , Wo          , Wwr         , Wo          , Ww          , Ww          , Ww          , Ww          
Wwr         , Wwr         , Wwr         , Gg          , Wwr         , Gg          , Wwr         , Gg          , Wwr         , Gg          , Wwr         , Wwr         , Gg          , Gg          , Ww          , Ww          , Gg          , Gg          , Gg          , Ww          , Gg          , Gg          , Ww          , Ww          , Ww          , Gg          , Gg          , Ww          , Gg          , Gg          , Ww          , Ww          , Ww          , Ww          , Gg          , Ww          , Wwr         , Gg          , Wwr         , Wwr         , Gg          , Wwr         , Wwr         , Ww          , Wwr         , Wwr         
Gg          , Gg          , Gg          , Wwr         , Gg          , Wwr         , Wwr         , Wwr         , Wwr         , Wwr         , Wwr         , Wwr         , Ww          , Ww          , Gg          , Ww          , Ww          , Ww          , Ww          , Ww          , Ww          , Ww          , Ww          , Gg          , Ww          , Ww          , Ww          , Ww          , Ww          , Gg          , Ww          , Ww          , Gg          , Ww          , Ww          , Ww          , Gg          , Wwr         , Gg          , Wwr         , Gg          , Wwr         , Gg          , Wwr         , Gg          , Gg          
Gs^Fp       , Gg          , Gs^Fp       , Gg          , Gs^Fp       , Gg          , Gg          , Gg          , Gg          , Gg          , Gg          , Ww          , Gg          , Ggf         , Gg          , Gg          , Gg          , Gg          , Gg          , Ww          , Gg          , Ww          , Gg          , Gg          , Gg          , Ww          , Gg          , Ww          , Gg          , Ww          , Gg          , Gg          , Ggf         , Gg          , Ww          , Ww          , Gg          , Gg          , Gg          , Gg          , Gg          , Gg          , Gg          , Gg          , Gg          , Gg          
Gg          , Gs^Fp       , Gg          , Gg^Ve       , Gg          , Gs^Fp       , Gg          , Gg          , Ggf         , Ggf         , Gg^Wm       , Ww          , Ww          , Ggf         , Gg          , Gg          , Gg          , Gg          , Gg          , Ggf         , Gg          , Gg          , Gg          , Gg          , Gg          , Gg          , Gg          , Gg          , Gg          , Gg          , Gg          , Gg          , Gg          , Ggf         , Ww          , Gg          , Gg^Vh       , Gg          , Gg          , Gg          , Gg          , Gg          , Gg          , Gg          , Gg          , Gg          
Gg          , Gs^Fp       , Gs^Fp       , Gs^Fp       , Gs^Fp       , Gs^Fp       , Gg          , Gg          , Ggf         , Gg          , Ggf         , Gg          , Ww          , Gg          , Gg          , Ggf         , Gg          , Ggf         , Ggf         , Gg          , Gg          , Gg          , Ggf         , Ggf         , Gg          , Gg          , Gg          , Gg          , Gg          , Ggf         , Gg          , Gg          , Gg          , Gg          , Ww          , Gg          , Gg          , Gg          , Gg          , Gg          , Gg          , Gg          , Gg          , Gg^Vh       , Gg          , Gg          
Gg          , Gs^Fp       , Gg          , Gs^Fp       , Gs^Fp       , Gg          , Gs^Fp       , Gs^Fp       , Gg          , Ggf         , Gg          , Ggf         , Ww          , Gg          , Gg^Vh       , Gg          , Gg          , Ggf         , Gg          , Gg          , Gg          , Gg          , Gg          , Gg          , Ch          , Gg          , Gg          , Gg          , Ch          , Ggf         , Gg          , Gg          , Ggf         , Gg          , Ww          , Gg          , Gg          , Gg          , Gg          , Gg          , Gg          , Gg^Wm       , Gg          , Gg          , Gg          , Gg          
Gs^Fp       , Gg          , Gs^Fp       , Gg          , Gg          , Gs^Fp       , Gs^Fp       , Gs^Fp       , Gg          , Gg          , Gg          , Ggf         , Ww          , Ggf         , Gg          , Gg          , Gg          , Gg          , Gg          , Gg          , Ch          , Gg          , Ch          , Ch          , Re^Gvs      , Ch          , Ch          , Ch          , Re^Gvs      , Ch          , Gg          , Gg          , Ww          , Ww          , Gg          , Gg          , Gg          , Gg          , Gg          , Gg^Vh       , Gg          , Gg          , Gg          , Gg          , Gg          , Gg          
Gg          , Gg          , Gs^Fp       , Gg          , Gs^Fp       , Gs^Fp       , Gg          , Gs^Fp       , Gs^Fp       , Gs^Fp       , Gs^Fp       , Ww          , Ww          , Gg          , Gg          , Gg          , Ggf         , Ggf         , Gg          , Ch          , Re^Gvs      , Ch          , Rr          , Rr          , Rr          , Re^Gvs      , 1 Kh        , Re^Gvs      , Rr          , Ch          , Gg          , Gg          , Ww          , Gg          , Gg          , Gg          , Gg          , Gg          , Gg          , Gg          , Gg          , Gg          , Gg          , Gg          , Gg          , Gg          
Gg          , Gs^Fp       , Gg^Ve       , Gs^Fp       , Gg          , Gg          , Gs^Fp       , Gg          , Gg          , Gs^Fp       , Ww          , Ww          , Gg          , Ww          , Ww          , Gg          , Gg          , Gg          , Gg          , Ch          , Rr          , Rp^Vhc      , Rr          , Re^Gvs      , Rr          , Rp^Vhc      , Rr          , Rp^Vhc      , Re^Gvs      , Rr          , Gg          , Ww          , Gg          , Gg          , Gg          , Gg^Vh       , Gg          , Gg          , Gg          , Gg          , Gg          , Gg          , Gg          , Gg          , Gg          , Gg          
Gg          , Gs^Fp       , Gs^Fp       , Gs^Fp       , Gs^Fp       , Gs^Fp       , Gs^Fp       , Gs^Fp       , Gs^Fp       , Gs^Fp       , Ww          , Gs^Fp       , Gg          , Gg          , Gg          , Ww          , Ww          , Ggf         , Gg          , Re^Gvs      , Re^Gvs      , Re^Gvs      , Re^Gvs      , Rp^Vhc      , Re^Gvs      , Re^Gvs      , Re^Gvs      , Rr          , Rr          , Rp^Vhc      , Ww          , Ww          , Gg          , Gg          , Gg          , Gg          , Gg          , Gg          , Gg          , Gg          , Gg          , Gg          , Gg          , Gg          , Gg          , Gg          
Gg          , Gs^Fp       , Gs^Fp       , Gg          , Gs^Fp       , Gs^Fp       , Gg          , Gg          , Gs^Fp       , Ww          , Gg          , Gs^Fp       , Gg          , Gg          , Gg          , Gg          , Ww          , Gg          , Gg          , Re^Gvs      , Re^Gvs      , Re^Gvs      , Re^Gvs      , Re^Gvs      , Re^Gvs      , Re^Gvs      , Re^Gvs      , Re^Gvs      , Re^Gvs      , Re^Gvs      , Ww          , Gg          , Gg          , Gg          , Gg          , Gg          , Gg          , Gg          , Gg          , Gg          , Gg          , Gg          , Gg          , Gg          , Gg          , Gg          
