border_size=1
usage=map

Mm          , Mm          , Mm          , Hh          , Hh          , Hh          , Mm          , Gs^Fp       , Hh          , Ur          , Ur          , Ur          , Ur          , Hh          , Mm          , Hh          , Hh^Fp       , Hh^Fp       , Ur          , Ur          , Ur          , Ur          , Mm          , Ur          , Hh          , Hh          , Ss          , Ss          
Mm          , Mm          , Hh          , Hh          , Mm          , Mm          , Hh^Fp       , Hh          , Ur          , Hh          , Hh          , Ur          , Hh          , Hh          , Hh          , Hh^Fp       , Mm          , Ur          , Mm          , Mm          , Hh^Fp       , Ur          , Hh          , Hh          , Ur          , Hh          , Hh          , Hh^Fp       
Mm          , Mm          , Hh^Vo       , Hh          , Hh^Fp       , Hh^Fp       , Hh          , Hh^Fp       , Hh          , Hh^Fp       , Hh^Fp       , Hh^Fp       , Hh          , Hh          , Hh          , Hh          , Mm          , Ur          , Ur          , Hh^Fp       , Ur          , Hh^Vhh      , Hh          , Hh          , Hh          , Hh          , Hh          , Hh^Fp       
Mm          , Mm          , Hh^Fp       , Hh^Fp       , Hh^Vhh      , Hh          , Ur          , Hh^Fp       , Hh^Fp       , Hh^Fp       , Hh          , Hh^Fp       , Hh          , Mm          , Hh          , Mm          , Hh          , Hh          , Hh^Fp       , Hh          , Hh          , Ur          , Hh          , Hh          , Hh          , Hh          , Hh          , Mm          
Mm          , Hh^Fp       , Hh^Fp       , Hh^Fp       , Hh^Fp       , Ur          , Hh^Fp       , Hh^Fp       , Hh^Fp       , Ha          , Hh          , Hh^Fp       , Hh^Fp       , Hh          , Hh          , Hh          , Hh          , Hh          , Hh^Fp       , Ur          , Hh          , Ur          , Hh          , Hh          , Mm          , Mm          , Mm          , Mm          
Mm          , Mm          , Hh          , Hh          , Hh          , Hh^Fp       , Hh          , Hh^Fp       , Hh          , Hh^Fp       , Hh^Fp       , Hh^Fp       , Hh^Fp       , Hh          , Hh          , Hh          , Hh          , Ur          , Hh          , Hh          , Hh          , Hh          , Hh          , Mm          , Hh          , Hh          , Mm          , Mm          
Mm          , Mm          , Mm          , Hh^Vhh      , Mm          , Mm          , Hh          , Hh          , Hh          , Hh          , Hh          , Hh^Fp       , Hh          , Hh          , Mm          , Hh          , Hh^Vhh      , Hh          , Mm          , Hh          , Hh          , Mm          , Mm          , Hh          , Mm          , Mm          , Hh          , Mm          
Mm          , Mm          , Mm          , Mm          , Mm          , Mm          , Mm          , Hh          , Hh          , Mm          , Hh          , Hh          , Hh          , Mm          , Mm          , Mm          , Hh          , Hh          , Hh          , Mm          , Mm          , Mm          , Mm          , Hh          , Hh          , Hh          , Mm          , Mm          
Mm          , Mm          , Hh          , Hh          , Mm          , Hh          , Hh          , Hh          , Hh^Fp       , Hh          , Hh          , Mm          , Mm          , Hh          , Hh          , Hh          , Mm          , Mm          , Mm          , Hh          , Hh          , Hh          , Hh^Fp       , Hh          , Mm          , Mm          , Gg^Vh       , Mm          
Mm          , Hh^Fp       , Hh^Fp       , Hh^Fp       , Mm          , Mm          , Hh          , Hh          , Mm          , Hh          , Hh          , Mm          , Hh          , Mm          , Mm          , Mm          , Mm          , Mm          , Mm          , Mm          , Hh          , Hh          , Hh^Fp       , Hh^Fp       , Hh^Fp       , Mm          , Mm          , Mm          
Hh          , Hh          , Gg^Ve       , Hh^Fp       , Hh          , Hh          , Mm          , Mm          , Mm          , Mm          , Hh          , Hh          , Hh          , Mm          , Hh          , Mm          , Mm          , Hh          , Mm          , Hh          , Hh          , Hh          , Gs^Fp       , Hh^Fp       , Gg          , Gg          , Gg          , Gg          
Gg          , Hh          , Hh          , Hh^Fp       , Hh          , Mm          , Mm          , Mm          , Hh          , Hh          , Gg          , Gg          , Gg          , Hh          , Gg          , Gg          , Gg          , Mm          , Mm          , Hh          , Hh          , Gg          , Gg          , Gg^Vh       , Gg          , Gg          , Gg          , Gg          
Gg          , Gg          , Hh^Fp       , Gg          , Hh          , Mm          , Hh          , Hh          , Aa          , Aa          , Ai          , Ai          , Gg          , Gg          , Gg          , Gg          , Gg          , Gg          , Gg          , Ha          , Aa          , Gg          , Gg          , Gg          , Gg          , Gg          , Gg          , Gg          
Gg          , Gg          , Gg          , Gg          , Gg          , Hh          , Re          , Aa          , Aa          , Ai          , Ai          , Gg          , Gg          , Gg          , Gg          , Gg          , Re          , Mm          , Mm          , Ha          , Aa          , Aa          , Aa          , Aa          , Aa          , Ai          , Gg          , Gg          
Gg          , Gg          , Gg          , Gg          , Gg          , Gg          , Re          , Ai          , Aa          , Aa          , Aa          , Hh          , Re          , Re          , Mm          , Mm^Vhh      , Re          , Mm          , Mm          , Hh          , Gg          , Gg          , Gg          , Aa          , Aa          , Ai          , Gg          , Gg          
Gg          , Gg          , Gg          , Gg          , Gg          , Gg          , Re          , Re          , Gg^Vh       , Gg          , Gg          , Gg          , Mm          , Re          , Mm          , Re          , Re          , Mm          , Hh          , Gg          , Gg          , Gg          , Gg          , Gg          , Aa          , Ai          , Ai          , Gg          
Gg          , Aa          , Aa          , Aa          , Gg          , Gg          , Gg          , Re          , Re          , Gg^Vh       , Gg          , Gg          , Gs^Fp       , Hh          , Re          , Re          , Gg          , Re          , Gg          , Gg          , Gg          , Re          , Gg          , Gg          , Gg          , Gg          , Gg          , Gg          
Gg          , Gg          , Aa          , Gg          , Gg          , Gs^Fp       , Gs^Fp       , Ss          , Re          , Re          , Gs^Fp       , Gs^Fp       , Gs^Fp       , Hh          , Hh          , Re          , Gg          , Gg          , Gg          , Re          , Re          , Re          , Gg          , Gg          , Gg          , Gg          , Gg          , Gg          
Gg          , Gg          , Gg          , Gg          , Hh          , Gg          , Gg          , Hh          , Hh          , Hh          , Gs^Fp       , Gg          , Gg          , Hh          , Hh          , Re          , Re          , Gg          , Gg          , Re          , Gg          , Gg          , Re          , Gg          , Gg          , Gg          , Gg          , Gg          
Re          , Gg          , Gg          , Gg          , Hh          , Gg          , Gg          , Gg          , Gg          , Gg          , Gs^Fp       , Gg          , Hh          , Ha          , Hh          , Re          , Re          , Re          , Re          , Re          , Re          , Re          , Re          , Gg          , Gg          , Gg          , Gs^Fp       , Gs^Fp       
Gg          , Re          , Re          , Gg          , Hh          , Gg          , Gg          , Gg          , Hh          , Gg          , Gs^Fp       , Hh          , Hh          , Mm          , Mm          , Mm          , Hh          , Hh          , Hh^Vhh      , Re          , Gg          , Gg          , Re          , Gg^Vh       , Re          , Gg          , Gg          , Gs^Fp       
Gg          , Hh^Vhh      , Re          , Gg          , Gs^Fp       , Hh          , Hh^Vhh      , Hh          , Gg          , Gs^Fp       , Gg          , Hh          , Ai          , Ai          , Gg          , Mm          , Hh          , Hh          , Gs^Fp       , Gs^Fp       , Gg          , Gg          , Re          , Re          , Re          , Gg          , Gg          , Gs^Fp       
Gg          , Hh          , Gg          , Re          , Gg          , Re          , Gg          , Gg          , Gs^Fp       , Gg          , Gg          , Ha          , Ai          , Ai          , Gg          , Gg          , Gg          , Gs^Fp       , Gs^Fp       , Gs^Fp       , Gg          , Gs^Fp       , Gg          , Re          , Gg          , Re          , Re          , Gg          
Hh          , Hh          , Hh          , Re          , Re          , Gs^Fp       , Gg          , Gg          , Gg          , Gg          , Ai          , Ai          , Ai          , Ai          , Hh          , Gg          , Gg          , Gs^Fp       , Gs^Fp       , Gg          , Gs^Fp       , Gg          , Gg          , Gg          , Gg          , Re          , Re          , Re          
Gg          , Hh          , Hh          , Gs^Fp       , Re          , Gg          , Re          , Gg          , Re          , Gg          , Hh          , Ai          , Ai          , Hh          , Hh          , Gg          , Gg          , Gs^Fp       , Gs^Fp       , Gs^Fp       , Re          , Re          , Re          , Gg          , Re          , Re          , Gg          , Re          
Gg          , Gg          , Gs^Fp       , Gs^Fp       , Gs^Fp       , Re          , Gg          , Ch          , Gg          , Re          , Gg^Vh       , Ha          , Hh          , Hh          , Gg          , Gg          , Gg          , Gg          , Re          , Re          , Gs^Fp       , Gs^Fp       , Gs^Fp       , Re          , Gg          , Re          , Re          , Gg          
Gg          , Gs^Fp       , Gs^Fp       , Gs^Fp       , Gs^Fp       , Gg          , Gg          , Hh          , Gg          , Re          , Re          , Gg          , Gg          , Hh          , Hh          , Gg          , Re          , Hh          , Re          , Gs^Fp       , Gs^Fp       , Gs^Fp       , Gs^Fp       , Gg          , Gg          , Gs^Fp       , Gg          , Re          
Gg          , Gs^Fp       , Gs^Fp       , Gg          , Gg          , Gg          , Gg^Vh       , Hh          , Hh          , Hh          , Gg          , Re          , Re          , Hh          , Re          , Re          , Gg          , Ch          , Gs^Fp       , Gs^Fp       , Ss          , Gs^Fp       , Gs^Fp       , Gg          , Gg          , Gs^Fp       , Gs^Fp       , Re          
Gs^Fp       , Gs^Fp       , Gg          , Gs^Fp       , Gg          , Gg          , Ds          , Ds          , Ds          , Gg          , Hh          , Gg          , Gg^Vh       , Gg          , Gg          , Gg          , Gg^Vh       , Re          , Gs^Fp       , Gs^Fp       , Gs^Fp       , Gs^Fp       , Gs^Fp       , Gs^Fp       , Gs^Fp       , Ss          , Ds          , Ds          
Ds          , Ds          , Ds          , Ds          , Ds          , Ds          , Ds          , Ds          , Ww          , Ds          , Aa          , Ai          , Ds          , Gg          , Ds          , Gg          , Gg          , Re          , Gs^Fp       , Gg          , Gg          , Gg          , Gg          , Gs^Fp       , Ds          , Ds          , Ds          , Ds          
Ww          , Ww          , Ww          , Ds          , Ww          , Ww          , Ww          , Ww          , Wo          , Wo          , Wo          , Ww          , Ww          , Ds          , Ds          , Ds          , Ds          , Re          , Re          , Ds          , Ds          , Ds          , Ds          , Ds          , Ds          , Ds          , Ds          , Ww          
Wo          , Wo          , Wo          , Wo          , Wo          , Wo          , Wo          , Wo          , Wo          , Wo          , Wo          , Wo          , Wo          , Wo          , Wo          , Ww          , Ww          , Ds          , 1 Ds        , Re          , Ww^Vm       , Ds          , Ds          , Ds          , Ww          , Ww          , Ww          , Wo          
Wo          , Wo          , Wo          , Wo          , Wo          , Wo          , Wo          , Wo          , Wo          , Wo          , Wo          , Wo          , Wo          , Wo          , Wo          , Wo          , Ww          , Ww          , Ww          , Ww          , Ww          , Ww          , Ww          , Wo          , Wo          , Wo          , Wo          , Wo          
Wo          , Wo          , Wo          , Wo          , Wo          , Wo          , Wo          , Wo          , Wo          , Wo          , Wo          , Wo          , Wo          , Wo          , Wo          , Wo          , Wo          , Wo          , Wo          , Wo          , Wo          , Wo          , Wo          , Wo          , Wo          , Wo          , Wo          , Wo          
Wo          , Wo          , Wo          , Wo          , Wo          , Wo          , Wo          , Wo          , Wo          , Wo          , Wo          , Wo          , Wo          , Wo          , Wo          , Wo          , Wo          , Wo          , Wo          , Wo          , Wo          , Wo          , Wo          , Wo          , Wo          , Wo          , Wo          , Wo          
Wo          , Wo          , Wo          , Wo          , Wo          , Wo          , Wo          , Wo          , Wo          , Wo          , Wo          , Wo          , Wo          , Wo          , Wo          , Wo          , Wo          , Wo          , Wo          , Wo          , Wo          , Wo          , Wo          , Wo          , Wo          , Wo          , Wo          , Wo          
Wo          , Wo          , Wo          , Wo          , Wo          , Wo          , Wo          , Wo          , Wo          , Wo          , Wo          , Wo          , Wo          , Wo          , Wo          , Wo          , Wo          , Wo          , Wo          , Wo          , Wo          , Wo          , Wo          , Wo          , Wo          , Wo          , Wo          , Wo          
Wo          , Wo          , Wo          , Wo          , Wo          , Wo          , Wo          , Wo          , Wo          , Wo          , Wo          , Wo          , Wo          , Wo          , Wo          , Wo          , Wo          , Wo          , Wo          , Wo          , Wo          , Wo          , Wo          , Wo          , Wo          , Wo          , Wo          , Wo          
Wo          , Wo          , Wo          , Wo          , Wo          , Wo          , Wo          , Wo          , Wo          , Wo          , Wo          , Wo          , Wo          , Wo          , Wo          , Wo          , Wo          , Wo          , Wo          , Wo          , Wo          , Wo          , Wo          , Wo          , Wo          , Wo          , Wo          , Wo          
Wo          , Wo          , Wo          , Wo          , Wo          , Wo          , Wo          , Wo          , Wo          , Wo          , Wo          , Wo          , Wo          , Wo          , Wo          , Wo          , Wo          , Wo          , Wo          , Wo          , Wo          , Wo          , Wo          , Wo          , Wo          , Wo          , Wo          , Wo          
Wo          , Wo          , Wo          , Wo          , Wo          , Wo          , Wo          , Wo          , Wo          , Wo          , Wo          , Wo          , Wo          , Wo          , Wo          , Wo          , Wo          , Wo          , Wo          , Wo          , Wo          , Wo          , Wo          , Wo          , Wo          , Wo          , Wo          , Wo          
Wo          , Wo          , Wo          , Wo          , Wo          , Wo          , Wo          , Wo          , Wo          , Wo          , Wo          , Wo          , Wo          , Wo          , Wo          , Wo          , Wo          , Wo          , Wo          , Wo          , Wo          , Wo          , Wo          , Wo          , Wo          , Wo          , Wo          , Wo          
