border_size=1
usage=map

Xos         , Wwf         , Wwf         , Ql          , Ql          , Ql          , Ql          , Ql          , Ql          , Ql          , Dw          , Dw          , Dw          , Uh          , Ur          , Uh          , Ur          , Uh          , Uh          , Uh          , Uh          , Uh          , Uh          , Uh          , Uh          , Wwf         , Uh          , Uh          , Dw          , Dw          , Uh          , Ql          , Ql          , Ql          , Ql          , Ql          , Uh          , Uh          , Uh          , Uh          , Uh          , Xos         
Xos         , Uu^Uf       , Uu^Uf       , Wwf         , Wwf         , Ql          , Ql          , Ql          , Dw          , Uu^Vu       , Dw          , Dw          , Dw          , Dw          , Uh          , Ur          , Uu^Vud      , Ur          , Uh          , Uh          , Uh          , Uh          , Wwf         , Wwf         , Wwf         , Wwf         , Uh          , Rp^Vhc      , Uh          , Dw          , Dw          , Dw          , Uh          , Uh          , Uh          , Ql          , Ql          , Uh          , Uh          , Uh          , Rp^Vhc      , Xos         
Xos         , Uu^Uf       , Uu^Vu       , Dw          , Ql          , Wwf         , Ql          , Ql          , Dw          , Uu^Uf       , Uu^Uf       , Dw          , Dw          , Dw          , Dw          , Uh          , Uh          , Ur          , Ur          , Uh          , Wwf         , Wwf         , Cud         , Uh          , Uh          , Uh          , Uh          , Uh          , Cud         , Uh          , Dw          , Dw          , Uh          , Uh          , Uh          , Uh          , Uh          , Ql          , Ql          , Dw          , Dw          , Xos         
Xos         , Uu^Uf       , Ql          , Dw          , Ql          , Wwf         , Wwf         , Rp^Vhc      , Uu^Uf       , Uu^Uf       , Uu^Uf       , Wwf         , Dw          , Dw          , Dw          , Rp^Vhc      , Uh          , Uu^Vu       , Ur          , Uh          , Wwf         , Cud         , Uu^Vud      , Cud         , Cud         , 2 Kud       , Cud         , Cud         , Uu^Vud      , Cud         , Uh          , Dw          , Dw          , Uh          , Uh          , Rp^Vhc      , Uh          , Uh          , Dw          , Dw          , Uu^Vud      , Xos         
Xos         , Ql          , Ql          , Dw          , Dw          , Wwf         , Wwf         , Dw          , Dw          , Uu^Uf       , Uu^Uf       , Wwf         , Wwf         , Dw          , Wwf         , Dw          , Uh          , Uh          , Ur          , Uh          , Wwf         , Cud         , Cud         , Cud         , Uh          , Cud         , Uh          , Cud         , Cud         , Cud         , Uh          , Uh          , Uh          , Dw          , Dw          , Uh          , Dw          , Dw          , Uh          , Ql          , Uh          , Xos         
Xos         , Wwf         , Wwf         , Dw          , Dw          , Dw          , Rp^Vhc      , Wwf         , Uu^Vu       , Dw          , Dw          , Uu^Uf       , Uu          , Wwf         , Uu          , Wwf         , Wwf         , Uh          , Wwf         , Wwf         , Wwf         , Uh          , Uh          , Uh          , Uh          , Uu          , Uu          , Uu          , Uu          , Uu          , Uu          , Uu          , Uu          , Uu          , Dw          , Dw          , Uh          , Uh          , Uh          , Uu^Uf       , Uu^Uf       , Xos         
Xos         , Uu          , Uu^Vud      , Dw          , Dw          , Uu          , Wwf         , Wwf         , Wwf         , Wwf         , Wwf         , Dw          , Wwf         , Wwf         , Uu          , Uu          , Uu          , Wwf         , Uu^Vud      , Dw          , Uh          , Wwf         , Wwf         , Wwf         , Wwf         , Wwf         , Wwf         , Uu          , Uu          , Uu          , Uu          , Uu          , Uu^Vud      , Dw          , Uu          , Uu          , Uh          , Uh          , Uh          , Uu^Uf       , Ql          , Xos         
Xos         , Uu          , Uu          , Uu          , Uu          , Uu          , Wwf         , Wwf         , Xos         , Wwf         , Xos         , Wwf         , Dw          , Dw          , Uu          , Uu          , Xos         , Uu          , Xos         , Cud         , Xos         , Rp^Vhc      , Xos         , Cud         , Xos         , Uu^Vu       , Xos         , Wwf         , Wwf         , Uu^Uf       , Uu          , Uu          , Uu          , Dw          , Uu          , Uu          , Rp^Vhc      , Uh          , Uh          , Uh          , Ql          , Xos         
Hh          , Xos         , Xos         , Uu          , Xos         , Uu          , Xos         , Xos         , Gg^Vh       , Xos         , Ww          , Xos         , Xos         , Xos         , Xos         , Cud         , Uu          , Xos         , Dw          , Dw          , Dw          , Xos         , Dw          , Uu          , Uu          , Xos         , Dw          , Cud         , Wwf         , Uu^Uf       , Uu^Uf       , Uu^Vu       , Dw          , Dw          , Uu          , Uu          , Uu          , Uu          , Wo          , Wo          , Ql          , Xos         
Hh          , Hh          , Hh          , Xos         , Hh          , Xos         , Hh          , Hh          , Ww          , Ww          , Hh          , Ww          , Ww          , Ww          , Ww          , Xos         , Xos         , Cud         , Xos         , Cud         , Xos         , Cud         , Xos         , Cud         , Xos         , Cud         , Xos         , Xos         , Wwf         , Dw          , Dw          , Uu^Uf       , Wwf         , Uu          , Wwf         , Wwf         , Wo          , Wo          , Wo          , Wo          , Xos         , Xos         
Ww          , Ww          , Mm          , Mm          , Hh          , Hh          , Hh          , Hh^Vhh      , Ww          , Hh          , Hh          , Ww          , Hh          , Hh          , Ww          , Ww          , Hh          , Hh          , Hh          , Hh          , Ww          , Hh          , Aa          , Aa          , Gg          , Gg          , Gg          , Xos         , Xos         , Wwf         , Wwf         , Wwf         , Xos         , Wwf         , Xos         , Xos         , Xos         , Wo          , Xos         , Wo          , Wo          , Ww          
Ww          , Ww          , Mm          , Mm          , Hh          , Hh          , Ww          , Ww          , Hh          , Hh          , Hh          , Hh          , Hh          , Hh          , Hh^Vhh      , Ww          , Ww          , Hh          , Ww          , Ww          , Ww          , Ai          , Ai          , Ai          , Aa          , Aa          , Ww          , Ww          , Re          , Xos         , Xos         , Xos         , Aa          , Xos         , Aa          , Aa          , Ha          , Xos         , Ww          , Wo          , Wo          , Ai          
Ww          , Ww          , Ww          , Hh          , Ww          , Ww          , Hh          , Hh          , Hh          , Hh          , Hh          , Hh          , Hh          , Hh          , Hh          , Ww          , Hh          , Ww          , Hh          , Gg          , Gg^Vh       , Ww          , Aa          , Ww          , Ww          , Ww          , Ww          , Gg^Vh       , Re          , Gg          , Gg          , Gg^Vh       , Aa          , Aa          , Aa          , Aa          , Ha          , Ww          , Ww          , Wo          , Mm          , Ai          
Ww          , Ww          , Mm          , Ww          , Hh          , Hh          , Hh          , Hh          , Hh          , Hh          , Mm          , Mm          , Mm          , Mm          , Hh          , Hh          , Hh          , Hh          , Hh          , Gg          , Gg          , Gg          , Aa          , Aa          , Gg          , Gg          , Gg          , Re          , Gg          , Gg          , Gg          , Gg          , Gg          , Aa          , Gg          , Gg          , Hh          , Ww          , Ww          , Mm^Vhh      , Mm          , Ai          
Mm          , Mm          , Mm          , Mm          , Mm          , Hh          , Mm          , Mm          , Ha          , Ha          , Mm          , Mm          , Mm          , Ha          , Mm          , Hh          , Hh          , Hh          , Hh          , Gg          , Gg          , Gg          , Aa          , Aa          , Aa          , Gg          , Gg          , Re          , Gg          , Gg          , Gg          , Gg          , Gg          , Aa          , Gg          , Hh          , Hh          , Ww          , Ww          , Mm          , Mm          , Mm          
Mm          , Mm          , Mm          , Mm          , Mm          , Mm          , Mm          , Mm          , Mm          , Mm          , Mm          , Mm          , Mm          , Ce          , Ce          , Hh          , Hh          , Hh          , Hh          , Gg          , Gg          , Gg          , Aa          , Aa          , Gg          , Aa          , Re          , Re          , Gg          , Gg          , Gg          , Gs^Fp       , Gg          , Gg          , Gg          , Hh          , Hh          , Ww          , Ww          , Mm          , Mm          , Mm          
Mm          , Mm          , Mm          , Mm          , Mm          , Mm          , Mm          , Mm^Vhh      , Mm          , Mm          , Mm          , Mm          , Mm          , Mm          , Ce          , Ce          , Ce          , Gg^Vh       , Gg          , Gg^Vh       , Gg          , Gg          , Gg          , Gg          , Gg          , Gg          , Re          , Gg^Vh       , Gg          , Gg          , Gs^Fp       , Gg          , Gg          , Gg          , Hh          , Hh          , Hh          , Ww          , Ww          , Mm          , Mm          , Mm          
Mm          , Mm          , Mm          , Mm          , Mm          , Mm          , Mm          , Mm          , Mm          , Mm          , Mm          , Mm          , 5 Ke        , Ce          , Hh          , Hh          , Hh          , Gg          , Gg          , Gg          , Gg          , Gg          , Gg          , Gg          , Gg          , Gg          , Gg          , Re          , Re          , Gs^Fp       , Gg^Ve       , Gs^Fp       , Gg          , Gg          , Ha          , Hh          , Ce          , Hh          , Ww          , Hh          , Mm          , Mm          
Mm          , Mm          , Mm          , Mm          , Mm          , Mm          , Mm          , Mm          , Mm          , Mm          , Mm          , Mm          , Mm          , Hh          , Hh          , Ww          , Hh          , Gg          , Gg          , Gg          , Gg          , Gg          , Ce          , Gg          , Gg          , Aa          , Aa          , Aa          , Gg          , Re          , Gs^Fp       , Gg          , Gg          , Aa          , Ha          , Hh          , Ce          , Hh          , Ww          , Mm          , Mm          , Mm          
Mm          , Mm          , Mm          , Mm          , Mm          , Mm          , Mm          , Mm          , Mm          , Mm          , Mm          , Mm          , Mm          , Hh          , Ww          , Ww          , Hh          , Gg          , Gg          , Gg          , Gg          , Gg          , Ce          , Gg          , Gg          , Aa          , Aa          , Aa          , Gg          , Re          , Gs^Fp       , Gg          , Gg          , Aa          , Ce          , Ce          , Hh          , Ce          , Ww          , Mm          , Mm          , Mm          
Mm          , Mm          , Mm          , Mm          , Mm          , Mm          , Mm          , Mm          , Mm          , Mm          , Mm          , Mm          , Ww          , Ww          , Ww          , Ww          , Ww          , Gg          , Gg          , Gg          , Gg          , Gg          , 4 Ke        , Gg          , Gg          , Gg          , Aa          , Aa          , Gg          , Re          , Gg          , Gg          , Gg          , Ce          , Ha          , Ha          , Hh          , 3 Ke        , Hh^Vhh      , Ww          , Ww          , Mm          
Mm          , Mm          , Mm          , Mm          , Mm          , Mm          , Mm          , Mm          , Mm          , Mm          , Mm          , Ww          , Ww          , Ww          , Ww          , Ww          , Gs^Fp       , Gg          , Gg          , Aa          , Ce          , Ce          , Gg          , Ce          , Ce          , Gg          , Gg          , Gg          , Re          , Re          , Gs^Fp       , Gg          , Hh          , Aa          , Ha          , Ha          , Hh          , Hh          , Hh          , Ww          , Ww          , Mm          
Mm          , Mm^Vhh      , Mm          , Mm          , Mm          , Mm          , Mm          , Mm          , Mm          , Mm          , Mm          , Mm          , Ww          , Ww          , Ww          , Ww          , Gs^Fp       , Gg          , Gg          , Gg          , Aa          , Aa          , Ww          , Gg          , Gg          , Gg          , Re          , Re          , Gg          , Re          , Hh          , Hh          , Hh          , Ha          , Ha          , Hh          , Hh          , Hh          , Hh          , Ww          , Ww          , Mm          
Mm          , Mm          , Mm          , Mm          , Mm          , Mm          , Mm          , Mm          , Mm          , Mm          , Mm          , Mm          , Ww          , Hh          , Hh          , Ww          , Ww          , Gg          , Gg^Vh       , Aa          , Ai          , Ai          , Ww          , Gg          , Ww          , Gs^Fp       , Re          , Gg          , Gg          , Re          , Hh          , Hh          , Hh          , Hh          , Hh          , Hh          , Hh          , Hh          , Mm          , Mm          , Ww          , Mm          
Mm          , Mm          , Mm          , Mm          , Mm          , Mm          , Mm          , Mm          , Mm          , Mm          , Mm          , Mm          , Hh          , Hh          , Hh          , Ww          , Ww          , Ww          , Ww          , Ww          , Ai          , Aa          , Ww          , Ww          , Ww          , Re          , Gs^Fp       , Gs^Fp       , Gs^Fp       , Re          , Re          , Hh          , Hh          , Hh          , Hh          , Hh          , Hh^Vhh      , Hh          , Ww          , Ww          , Ww          , Ww          
Mm          , Mm          , Mm          , Mm          , Mm          , Mm          , Mm          , Mm          , Mm          , Mm          , Mm^Vhh      , Mm          , Hh          , Hh          , Hh          , Ww          , Gg^Vh       , Gg          , Ww          , Ww          , Aa          , Aa          , Ww          , Ww          , Ww          , Re          , Gs^Fp       , Gg^Ve       , Gs^Fp       , Hh          , Ww          , Re          , Re          , Hh          , Hh          , Ww          , Ww          , Ww          , Ww^Vm       , Ww          , Ww          , Ww          
Mm          , Mm          , Mm          , Mm          , Mm          , Mm          , Mm          , Mm          , Mm          , Mm          , Mm          , Hh          , Hh          , Hh          , Gg          , Gg          , Gg          , Gg          , Gg          , Gg          , Gg          , Gg          , Ww          , Ww          , Ww          , Re          , Gs^Fp       , Gs^Fp       , Gg          , Ww          , Ww          , Hh          , Ww          , Ww^Bw\      , Ch          , Ww          , Ww          , Ww          , Ww          , Ww          , Ww          , Ww          
Mm          , Mm          , Mm          , Mm          , Mm          , Mm          , Mm          , Mm          , Mm          , Mm          , Mm          , Hh          , Ha          , Ha          , Gg          , Gg          , Gg          , Gg          , Gg          , Gg          , Gg          , Gg          , Ww          , Ww          , Ww^Bw/      , Re          , Gs^Fp       , Gs^Fp       , Hh          , Ww          , Ww          , Ww          , Ww          , Ww          , Re          , Hh          , Hh          , Ww          , Ww          , Ww          , Ww          , Ww          
Mm          , Mm          , Mm          , Mm          , Mm          , Mm          , Mm          , Mm          , Mm          , Mm          , Hh          , Ha          , Ha          , Ha          , Aa          , Gg          , Gg          , Gg          , Gs^Fp       , Gs^Fp       , Gs^Fp       , Gs^Fp       , Re          , Re          , Ww          , Gs^Fp       , Gs^Fp       , Gs^Fp       , Hh          , Ww          , Ww          , Ww          , Ww          , Ww          , Re          , Hh          , Hh          , Ww          , Ww          , Ww          , Ww          , Mm          
Mm          , Mm          , Mm          , Mm          , Mm          , Mm          , Mm          , Mm          , Mm          , Mm          , Ha          , Ha          , Ha          , Ha          , Aa          , Gg          , Gg          , Gs^Fp       , Gs^Fp       , Gg          , Gs^Fp       , Re          , 1 Gg        , Gg          , Ww          , Gs^Fp       , Gg          , Gs^Fp       , Hh          , Hh          , Ww          , Ww          , Ww          , Ww          , Ww          , Re          , Re          , Hh          , Hh          , Ww          , Hh          , Hh          
Mm          , Mm          , Mm          , Mm          , Mm          , Mm          , Mm          , Mm          , Mm          , Mm          , Ha          , Ha          , Ha          , Ha          , Aa          , Gg          , Gg          , Gs^Fp       , Gs^Fp       , Gg          , Gg          , Re          , Gg          , Gs^Fp       , Ww          , Gg          , Gg          , Gg          , Hh          , Hh          , Ww          , Ww          , Hh^Vhh      , Hh          , Hh          , Hh          , Hh          , Re          , Re          , Hh          , Re          , Hh          
Mm          , Mm          , Mm          , Mm          , Mm          , Mm          , Mm          , Mm          , Mm          , Mm          , Mm          , Ha          , Ha          , Hh          , Gg          , Gg          , Gs^Fp       , Gs^Fp       , Gs^Fp       , Gs^Fp       , Gg          , Re          , Gg          , Gs^Fp       , Gg          , Ww          , Gg          , Gg          , Hh          , Ha          , Ha          , Ww          , Hh          , Hh          , Hh          , Hh          , Hh          , Hh          , Hh          , Re          , Hh          , Re          
