border_size=1
usage=map

Hh          , Hh          , Hh          , Hh          , Hh          , Hh          , Hh          , Hh          , Hh          , Ha          , Ha          , Ha          , Ha          , Ai          , Ww          , Gg          , Gg          , Hh          , Re          , Re          , Mm          , Ha          , Ha          , Ha          , Ha          , Hh          , Hh          , Hh          , Hh          , Hh          , Hh          , Hh          
Hh          , Hh          , Hh          , Hh          , Hh          , Hh          , Hh          , Hh          , Hh          , Ha          , Ha          , Ha          , Ha          , Ww          , Re          , Re          , Re          , Re          , Mm          , Mm          , Mm          , Mm          , Mm          , Mm          , Ha          , Ha          , Ha          , Hh          , Hh          , Hh          , Hh          , Hh          
Hh          , Hh          , Hh          , Hh          , Hh          , Hh          , Hh          , Hh^Vhh      , Hh          , Hh          , Ha          , Ha          , Ha          , Ww^Bw/      , Gg          , Gg          , Hh^Vhh      , Hh          , Mm          , Mm          , Mm          , Mm          , Mm          , Mm          , Ha          , Ha          , Aa          , Hh          , Hh          , Hh          , Ch          , Hh          
Hh          , Hh          , Hh          , Hh^Fms      , Hh          , Hh          , Hh          , Hh          , Hh          , Hh          , Re          , Ww          , Ww          , Ww          , Gg          , Gs^Fp       , Hh          , Mm          , Mm          , Mm          , Mm          , Mm          , Mm          , Mm          , Ha          , Ha          , Aa          , Hh          , Hh          , Hh          , Ch          , Hh          
Hh          , Hh          , Hh          , Hh          , Hh^Fms      , Hh          , Hh          , Hh          , Hh          , Hh          , Re          , Ww          , Gg^Vh       , Ww          , Ww          , Gs^Fp       , Hh          , Hh          , Mm          , Mm          , Mm          , Mm          , Mm          , Ha          , Cud         , Cud         , Cud         , Cud         , Hh          , Hh          , Hh          , Hh          
Hh          , Hh          , Hh          , Hh          , Hh          , Hh          , Hh          , Hh          , Gg          , Re          , Gg          , Ww          , Gg          , Gg          , Gs^Fp       , Ww          , Ww          , Hh          , Mm          , Mm          , Mm          , Mm          , Mm          , Cud         , Cud         , Cud         , Cud         , Hh          , Hh          , Hh          , Hh          , Gs^Fp       
Mm          , Hh          , Hh^Vhh      , Hh          , Hh          , Hh          , Mm          , Hh          , Re          , Re          , Ww^Bw\      , Ww          , Chr         , Gg          , Gs^Fp       , Gs^Fp       , Hh          , Ww          , Ww          , Hh          , Mm          , Mm          , Cud         , Cud         , Cud         , 3 Kud       , Cud         , Hh          , Hh          , Hh          , Hh          , Gs^Fp       
Hh          , Mm          , Ww          , Ww          , Ww^Bw/      , Hh          , Ww          , Ww          , Ww          , Ww          , Hh          , Rd          , Chr         , Hh          , Hh          , Hh          , Hh          , Hh          , Hh          , Ww          , Ww          , Hh          , Re          , Re          , Gg^Vh       , Gg          , Gg          , Hh          , Hh          , Hh          , Hh          , Hh          
Ww          , Ww          , Mm          , Mm          , Hh          , Ww          , Hh          , Hh          , Hh          , Hh          , Chr         , Chr         , 1 Khr       , Chr         , Hh          , Hh          , Hh          , Gg          , Gg          , Gg          , Ww^Bw/      , Re          , Gg          , Gg          , Gg          , Gg          , Gg          , Hh          , Hh          , Hh          , Hh          , Hh          
Wo          , Mm          , Aa          , Aa          , Aa          , Hh          , Hh^Vhh      , Hh          , Hh          , Gg          , Gg          , Chr         , Chr         , Chr         , Rd          , Gg          , Gg          , Aa          , Gg          , Gg          , Ww^Bw/      , Gg          , Gg          , Gg          , Gg          , Gg          , Gg          , Hh          , Hh          , Hh          , Hh          , Hh          
Wo          , Mm          , Aa          , Aa          , Aa          , Hh          , Hh          , Hh          , Gg          , Gg          , Gg          , Chr         , Chr         , Rd          , Rd          , Gg          , Aa          , Aa          , Re          , Re          , Ww          , Ww^Bw|      , Ww          , Gg          , Gg          , Aa          , Gg          , Hh          , Hh          , Hh          , Hh          , Hh          
Wo          , Hh          , Hh          , Aa          , Hh          , Hh          , Hh          , Hh          , Gs^Fp       , Gg          , Gg          , Gg          , Gg          , Rd          , Rd          , Re          , Aa          , Aa          , Aa          , Gg^Vh       , Ww          , Ww^Bw|      , Ww^Bw/      , Gg          , Aa          , Aa          , Aa          , Hh          , Hh          , Hh          , Hh          , Hh          
Hh          , Wo          , Wo          , Hh          , Hh          , Hh          , Hh          , Hh          , Hh          , Gg          , Gg          , Gg          , Gg          , Gg          , Gg          , Gg          , Aa          , Ai          , Ww          , Ww          , Ww^Bw|      , Ww^Bw/      , Ww          , Ww          , Ww          , Ai          , Gg          , Hh          , Gg          , Gg          , Hh          , Hh          
Hh          , Hh          , Hh          , Wo          , Hh          , Hh          , Hh          , Hh          , Hh          , Hh          , Gg          , Gg          , Gg^Vh       , Gg          , Gg          , Gg          , Re          , Ai          , Ww          , Ww          , Gg          , Ww          , Ww          , Ww          , Ww          , Ai          , Ww          , Gg          , Hh          , Hh          , Hh          , Hh          
Hh          , Hh          , Hh          , Wo          , Hh          , Hh          , Hh          , Hh          , Hh          , Hh          , Hh          , Gg          , Gg          , Gg          , Gg          , Gg          , Re          , Ww          , Gg          , Ww^Bw/      , Gg          , Ww          , Ww          , Ww          , Ww          , Aa^Vha      , Ww          , Gg          , Hh          , Hh          , Hh          , Hh          
Hh          , Hh          , Hh          , Wo          , Wo          , Hh          , Ms          , Hh          , Hh          , Hh          , Uh          , Gg          , Gg          , Gg          , Gg          , Gs^Fp       , Re          , Gg          , Ww          , Ww          , Gs^Fp       , Ww          , Ww          , Ww          , Ww          , Ww          , Ww          , Ww          , Hh^Fmw      , Hh          , Hh^Fmw      , Hh          
Hh          , Hh          , Mm          , Mm          , Wo          , Ms          , Ms          , Ms          , Uh          , Uh          , Uh          , Uh          , Gg          , Gg          , Gs^Fp       , Gs^Fp       , Gg          , Re          , Ww          , Gg^Ve       , Gs^Fp       , Gs^Fp       , Ww          , Ww          , Ww          , Ww          , Ww          , Hh          , Hh^Fmw      , Hh^Fmw      , Hh^Fmw      , Hh^Fmw      
Hh          , Mm          , Mm          , Mm          , Mm          , Wo          , Uh          , Uh          , Uh          , Uh          , Uh          , Uh          , Gg          , Gg          , Gs^Fp       , Gs^Fp       , Ww          , Ww^Bw|      , Gs^Fp       , Gs^Fp       , Gg          , Gs^Fp       , Gs^Fp       , Gg          , Ww          , Ww          , Ww          , Ww          , Hh^Fmw      , Hh^Vhh      , Hh^Fmw      , Hh^Fmw      
Wo          , Mm          , Wo          , Wo          , Wo          , Wo          , Uh          , Uh          , Hh^Vhh      , Uh          , Uh          , Gg          , Gg          , Gg          , Ww          , Ww          , Gg          , Re          , Gs^Fp       , Gs^Fp       , Gs^Fp       , Gs^Fp       , Gs^Fp       , Gs^Fp       , Ww          , Ww          , Ww          , Ww          , Wo          , Hh^Fmw      , Hh^Fmw      , Hh^Fmw      
Wo          , Wo          , Mm          , Wo          , Uh          , Wo          , Wo          , Uh          , Wo^Bw|      , Uh          , Uh          , Hh          , Ww^Bw\      , Ww          , Gg          , Gs^Fp       , Gs^Fp       , Re          , Gs^Fp       , Gs^Fp       , Gs^Fp       , Gg          , Gg          , Gg          , Gg          , Gg^Vh       , Wo          , Wo          , Hh^Fmw      , Wo^Bw|      , Wo          , Hh^Fmw      
Hh          , Hh          , Mm          , Mm          , Mm          , Hh          , Uh          , Wo          , Hh          , Wo          , Wo          , Ww          , Gg          , Gg          , Gg          , Gg          , Gg          , Re          , Gs^Fp       , Gs^Fp       , Gs^Fp       , Gg          , Gg          , Gg          , Gg          , Wo          , Hh          , Hh          , Hh^Fmw      , Hh^Fmw      , Hh^Fmw      , Wo          
Hh          , Hh          , Mm          , Hh          , Hh          , Hh          , Uh          , Hh          , Hh          , Uh          , Wo          , Gg          , Gg          , Gg^Vh       , Gg          , Gg          , Re          , Re          , Gg          , Gg          , Gg          , Aa          , Aa          , Aa          , Gg          , Wo          , Hh          , Hh          , Hh^Fmw      , Hh          , Gg          , Hh          
Hh          , Hh^Fms      , Hh^Fms      , Hh          , Hh          , Uh          , Uh          , Hh          , Hh          , Uh          , Gg          , Wo          , Gg          , Gg          , Aa          , Aa          , Ce          , Ce          , Ce          , Gg          , Gg          , Aa          , Aa          , Aa          , Wo          , Wo          , Gg          , Hh          , Hh          , Hh          , Gg          , Hh          
Hh^Fms      , Hh^Fms      , Hh^Fms      , Hh          , Hh          , Uh          , Uh          , Hh          , Uh          , Uh          , Gg          , Wo          , Gg          , Gg          , Re          , Re          , Ce          , Ce          , Gg          , Ce          , Ce          , Aa          , Aa          , Aa          , Wo          , Gg^Vh       , Hh          , Hh          , Gg          , Gg          , Gg^Vh       , Gg          
Hh^Fms      , Hh^Fms      , Hh          , Uh          , Uh          , Uh          , Uh          , Uh          , Uh          , Hh^Vhh      , Gg          , Wo          , Wo          , Gg          , Re          , Gs^Fp       , 6 Ke        , Gs^Fp       , Gg          , Gg          , Ce          , Gg          , Aa          , Wo          , Ha          , Gg          , Ms          , Ms          , Ms          , Ms          , Ms          , Ms          
Hh^Fms      , Hh          , Hh^Fms      , Uh          , Uh          , Uh          , Hh          , Hh          , Uh          , Hh          , Gg          , Gg          , Gg          , Wo          , Re          , Gs^Fp       , Gg          , Ce          , Ce          , Ce          , Ce          , Gg          , Gg          , Wo          , Ha          , Ha          , Ms          , Ms          , Ms          , Ms          , Ms          , Ms          
Hh          , Hh          , Hh^Fms      , Uh          , Uh          , Hh          , Hh          , Hh          , Uh          , Uh          , Gg          , Gg          , Re          , Ww^Bw/      , Gs^Fp       , Gg          , Gg          , Gg          , Gg          , Gg^Vh       , Wo          , Wo          , Wo          , Wo^Bw\      , Ha          , Ha          , Ha          , Hh          , Hh          , Ms          , Ms          , Ms          
Hh          , Hh          , Uh          , Uh          , Ce          , Hh^Fms      , Uh          , Uh          , Uh          , Uh          , Gg          , Gg          , Re          , Wo          , Wo          , Wo          , Gg^Vh       , Gg          , Wo          , Wo          , Gs^Fp       , Gg          , Gg          , Ai          , Ha          , Ha          , Ha          , Mm          , Hh          , Ms          , Ms          , Ms          
Hh          , Hh^Vhh      , Ce          , Ce          , Uh          , Ce          , Uh          , Uh          , Uh          , Gg          , Gg          , Gg          , Gg          , Re          , Gg          , Wo          , Wo          , Wo          , Wo          , Gg^Vh       , Gs^Fp       , Gg          , Gg          , Ha          , Ha          , Ha          , Ha          , Mm          , Hh          , Ms          , Ms          , Ms          
Hh          , Hh          , Ce          , Uh          , Hh^Fms      , Ce          , Ww          , Gg          , Gg          , Gg          , Ww          , Ww          , Gg          , Re          , Re          , Gs^Fp       , Gs^Fp       , Wo          , Gg          , Gg          , Gs^Fp       , Gg          , Gg          , Ha          , Ha          , Ha          , Ha          , Mm          , Mm          , Ms          , Ms          , Ms          
Hh^Fms      , Ce          , Ce          , 5 Ke        , Ce          , Ce          , Ww          , Gg          , Gg          , Gg          , Ww          , Ww          , Ha          , Gg          , Gg          , Re          , Re          , Wo          , Gs^Fp       , Gs^Fp       , Gg          , Gg          , Ha          , Ha          , Ha          , Ha          , Ha          , Mm          , Mm          , Hh          , Hh^Vhh      , Hh          
Hh^Fms      , Hh          , Hh          , Hh          , Hh^Fms      , Ce          , Ww          , Gg          , Ww          , Ww          , Ww          , Ww          , Ha          , Ha          , Gg          , Gg          , Re          , Wo^Bw\      , Wo^Bw\      , Gg          , Gg          , Ha          , Gg          , Gg          , Ha          , Gg          , Ha          , Ha          , Ha          , Mm          , Hh          , Hh          
Hh^Fms      , Hh^Fms      , Hh^Fms      , Hh^Fms      , Hh^Fms      , Hh^Fms      , Ww          , Gg^Vh       , Ww          , Ww          , Ww          , Ww          , Ha          , Gg          , Gg          , Gg          , Re          , Wo^Bw\      , Wo^Bw\      , Gg          , Gg          , Gg          , Gg          , Gg          , Gg          , Gg          , Gg          , Gg          , Ha          , Ha          , Ha          , Ha          
Hh          , Hh          , Hh^Fms      , Hh^Fms      , Hh^Fms      , Hh^Fms      , Gg          , Ww          , Ww          , Ww          , Gg          , Ww          , Ww          , Gg          , Gg          , Gg          , Gg          , Wo^Bw\      , Wo^Bw\      , Gg          , Gg          , Gg          , Gg          , Gg^Vh       , Gg          , Gg          , Gg          , Gg          , Gg          , Gg          , Ha          , Gg          
Hh          , Hh          , Hh^Fms      , Hh^Fms      , Ha          , Gg          , Ww          , Ww          , Ww          , Ww          , Ww          , Ww          , Ww          , Gg          , Gg          , Gs^Fp       , Gs^Fp       , Wo^Bw\      , Wo^Bw\      , Gs^Fp       , Gs^Fp       , Gg          , Gg          , Gg          , Gs^Fp       , Gg          , Gg          , Gg          , Ce          , Ce          , Ce          , Gg          
Hh          , Hh          , Hh^Vhh      , Ha          , Ha          , Gg          , Ww          , Ww          , Ww          , Ww          , Gg          , Ww          , Ww          , Gg          , Gs^Fp       , Gs^Fp       , Gs^Fp       , Gs^Fp       , Wo          , Re          , Gs^Fp       , Gs^Fp       , Gs^Fp       , Gs^Fp       , Gs^Fp       , Gs^Fp       , Gg          , Ce          , Gg          , Gg^Vh       , Ce          , Gg          
Ha          , Ha          , Hh          , Ha          , Gg          , Ha          , Gg          , Ww          , Ww          , Ww          , Gg          , Ww          , Ww          , Gg^Vh       , Gs^Fp       , Gs^Fp       , Gs^Fp       , Wo          , Gg          , Re          , Gs^Fp       , Gg          , Gg          , Gg          , Gs^Fp       , Gg          , Gg          , Ce          , Gg          , Gg          , Ce          , Ce          
Hh          , Ha          , Ha          , Ha          , Gg          , Gg          , Gs^Fp       , Gs^Fp       , Ww          , Ww          , Ww          , Ww          , Ww          , Ww          , Ww          , Gs^Fp       , Gs^Fp       , Wo          , Gg^Vh       , Re          , Gg          , Gs^Fp       , Gg          , Gs^Fp       , Gg          , Gg          , Gg          , Ce          , Gg          , Gg          , 4 Ke        , Ce          
Hh          , Hh          , Ha          , Ha          , Ha          , Ww          , Ww          , Ww          , Ww          , Ww          , Ww          , Gs^Fp       , Ww          , Ww          , Ww          , Ww          , Gs^Fp       , Wo          , Re          , Re          , Gg          , Gs^Fp       , Gg          , Gg          , Gg          , Gg          , Gg          , Gg          , Gg          , Gg          , Ce          , Ce          
Hh          , Hh^Fms      , Hh          , Ha          , Ha          , Ww          , Ww          , Ww          , Ww          , Ww          , Ww          , Gs^Fp       , Ww          , Ww          , Ww          , Ww          , Gs^Fp       , Wo          , Re          , Gg          , Gg          , Gg          , Gg          , Gg          , Gg          , Gg          , Aa          , Gg          , Gg          , Gg          , Gg          , Gg          
Hh^Fms      , Hh^Fms      , Hh^Fms      , Ha          , Ha          , Ww          , Ww          , Ww          , Ww          , Ww          , Ww          , Ww          , Ww          , Ww          , Gg^Vh       , Gg          , Gs^Fp       , Wo          , Re          , Aa          , Gg          , Gg          , Gg          , Gg          , Gg          , Gg          , Gg          , Gg          , Gg          , Gg          , Gg          , Gg          
Ha          , Hh^Fms      , Hh^Fms      , Ha          , Ha          , Ha          , Ww          , Ww          , Gg          , Gg^Vh       , Gg          , Gs^Fp       , Gs^Fp       , Gs^Fp       , Gg          , Gg          , Gs^Fp       , Wo          , Re          , Aa          , Aa          , Gg          , Gg          , Gg          , Gg          , Gg          , Gg          , Gg          , Gg          , Gg          , Gg          , Gg          
Ha          , Hh          , Hh          , Ha          , Ha          , Gg          , Ww          , Gg          , Gg          , Gg          , Gg          , Gg          , Gg          , Gs^Fp       , Gs^Fp       , Gs^Fp       , Ww          , Wo          , Ww          , Aa          , Gg          , Gg          , Gg          , Gg          , Gg          , Gg^Vh       , Hh          , Gg          , Gg          , Gg          , Gg          , Gg          
Ha          , Hh^Vhh      , Ha          , Ha          , Ha          , Ha          , Ww          , Gg^Vh       , Gg          , Gg          , Gg          , Gg          , Gg          , Gg          , Gg          , Ww          , Ww          , Ww          , Ww          , Ww          , Ww          , Gg          , Gg          , Gg          , Gg          , Hh          , Hh          , Hh          , Hh          , Gg          , Hh          , Gg          
Ha          , Hh          , Ha          , Gs^Fp       , Gs^Fp       , Ha          , Gs^Fp       , Gg          , Gg          , Gg          , Ce          , Gg          , Gg          , Gs^Fp       , Ce          , Ww          , Gg^Vh       , Ww          , Ww          , Ww          , Ww          , Gg          , Gg          , Gg          , Hh          , Hh          , Ha          , Gg          , Hh          , Hh          , Hh          , Hh          
Hh          , Ha          , Gs^Fp       , Gs^Fp       , Gs^Fp       , Gs^Fp       , Gs^Fp       , Gs^Fp       , Gg          , Gg          , Re          , Rd          , Rd          , Rd          , Re          , Ww          , Ww          , Ww          , Ww          , Ww          , Gg          , Gg          , Gg          , Gg          , Hh          , Hh          , Ha          , Gg          , Gg          , Hh          , Hh          , Ha          
Hh          , Hh          , Gs^Fp       , Gs^Fp       , Gg          , Gs^Fp       , Gs^Fp       , Gs^Fp       , Re          , Re          , Hh          , Ce          , Rd          , Ce          , Hh          , Gg^Vh       , Gg          , Gg          , Aa          , Aa          , Gg          , Gg          , Gg          , Gg          , Hh          , Hh          , Ha          , Ha          , Ha          , Ha          , Ha          , Ha          
Hh          , Hh          , Hh          , Gs^Fp       , Gs^Fp       , Gs^Fp       , Gs^Fp       , Re          , Gs^Fp       , Gs^Fp       , Ce          , Ce          , 2 Ke        , Ce          , Ce          , Hh          , Gg          , Gg          , Gg          , Gg          , Gg          , Gg          , Gg          , Gg          , Hh          , Gg^Vh       , Ha          , Ha          , Ha          , Ms          , Ms          , Ha          
Hh          , Hh          , Hh          , Hh          , Hh          , Hh          , Gs^Fp       , Re          , Gs^Fp       , Hh          , Hh          , Hh          , Hh          , Hh          , Hh          , Hh          , Hh          , Gg          , Gg          , Gg          , Gg          , Gs^Fp       , Gs^Fp       , Gs^Fp       , Hh          , Gg          , Ha          , Ha          , Ha          , Ms          , Ms          , Ha          
Hh          , Hh          , Hh          , Hh          , Hh          , Hh          , Hh          , Re          , Gs^Fp       , Hh          , Hh          , Mm          , Mm          , Hh          , Hh          , Hh          , Hh          , Gs^Fp       , Gg          , Gg          , Gg          , Gg^Ve       , Gs^Fp       , Gs^Fp       , Hh          , Hh          , Gg          , Ha          , Ms          , Mm          , Ha          , Ha          
Hh          , Gs^Fp       , Gg^Ve       , Hh          , Re          , Re          , Re          , Re          , Gg^Vh       , Hh          , Hh          , Hh          , Mm          , Hh          , Hh          , Hh          , Hh          , Gs^Fp       , Gg          , Gg          , Gg          , Gs^Fp       , Gs^Fp       , Gs^Fp       , Gs^Fp       , Hh          , Gg          , Hh          , Mm          , Ha          , Ha          , Ha          
Hh          , Gs^Fp       , Gs^Fp       , Re          , Gg          , Gg          , Aa          , Aa          , Hh          , Hh          , Hh          , Hh          , Hh          , Hh          , Hh          , Hh          , Hh          , Gs^Fp       , Gg          , Gg          , Gg          , Gg          , Gs^Fp       , Gs^Fp       , Gs^Fp       , Hh          , Gg          , Hh          , Mm          , Mm          , Mm          , Ha          
